Bulbasaur -> Ivysaur -> Venusaur

Charmander -> Charmeleon -> Charizard

Squirtle -> Wartortle -> Blastoise

Ekans -> Arbok

Pichu -> Pikachu -> Raichu, Raichu-Alola

Sandshrew -> Sandslash

Sandshrew-Alola -> Sandslash-Alola

Cleffa -> Clefairy -> Clefable

Vulpix -> Ninetales

Vulpix-Alola -> Ninetales-Alola

Igglybuff -> Jigglypuff -> Wigglytuff

Oddish -> Gloom -> Vileplume, Bellossom

Venonat -> Venomoth

Diglett -> Dugtrio

Diglett-Alola -> Dugtrio-Alola

Meowth -> Persian

Meowth-Alola -> Persian-Alola

Meowth-Galar -> Perrserker

Psyduck -> Golduck

Mankey -> Primeape -> Annihilape

Growlithe -> Arcanine

Growlithe-Hisui -> Arcanine-Hisui

Poliwag -> Poliwhirl -> Poliwrath, Politoed

Bellsprout -> Weepinbell -> Victreebel

Tentacool -> Tentacruel

Geodude -> Graveler -> Golem

Geodude-Alola -> Graveler-Alola -> Golem-Alola

Slowpoke -> Slowbro, Slowking

Slowpoke-Galar -> Slowbro-Galar, Slowking-Galar

Magnemite -> Magneton -> Magnezone

Doduo -> Dodrio

Seel -> Dewgong

Grimer -> Muk

Grimer-Alola -> Muk-Alola

Shellder -> Cloyster

Gastly -> Haunter -> Gengar

Drowzee -> Hypno

Voltorb -> Electrode

Voltorb-Hisui -> Electrode-Hisui

Exeggcute -> Exeggutor, Exeggutor-Alola

Koffing -> Weezing, Weezing-Galar

Rhyhorn -> Rhydon -> Rhyperior

Happiny -> Chansey -> Blissey

Horsea -> Seadra -> Kingdra

Scyther -> Scizor, Kleavor

Elekid -> Electabuzz -> Electivire

Magby -> Magmar -> Magmortar

Magikarp -> Gyarados

Eevee -> Vaporeon, Jolteon, Flareon, Espeon, Umbreon, Leafeon, Glaceon, Sylveon

Porygon -> Porygon2 -> Porygon-Z

Dratini -> Dragonair -> Dragonite

Chikorita -> Bayleef -> Meganium

Cyndaquil -> Quilava -> Typhlosion, Typhlosion-Hisui

Totodile -> Croconaw -> Feraligatr

Sentret -> Furret

Hoothoot -> Noctowl

Spinarak -> Ariados

Chinchou -> Lanturn

Mareep -> Flaaffy -> Ampharos

Azurill -> Marill -> Azumarill

Hoppip -> Skiploom -> Jumpluff

Aipom -> Ambipom

Sunkern -> Sunflora

Yanma -> Yanmega

Wooper -> Quagsire

Wooper-Paldea -> Clodsire

Murkrow -> Honchkrow

Misdreavus -> Mismagius

Girafarig -> Farigiraf

Pineco -> Forretress

Dunsparce -> Dudunsparce, Dudunsparce-Three-Segment

Gligar -> Gliscor

Snubbull -> Granbull

Qwilfish-Hisui -> Overqwil

Sneasel -> Weavile

Sneasel-Hisui -> Sneasler

Teddiursa -> Ursaring -> Ursaluna

Slugma -> Magcargo

Swinub -> Piloswine -> Mamoswine

Houndour -> Houndoom

Phanpy -> Donphan

Stantler -> Wyrdeer

Tyrogue -> Hitmonlee, Hitmonchan, Hitmontop

Larvitar -> Pupitar -> Tyranitar

Treecko -> Grovyle -> Sceptile

Torchic -> Combusken -> Blaziken

Mudkip -> Marshtomp -> Swampert

Poochyena -> Mightyena

Lotad -> Lombre -> Ludicolo

Seedot -> Nuzleaf -> Shiftry

Wingull -> Pelipper

Ralts -> Kirlia -> Gardevoir, Gallade

Surskit -> Masquerain

Shroomish -> Breloom

Slakoth -> Vigoroth -> Slaking

Makuhita -> Hariyama

Nosepass -> Probopass

Meditite -> Medicham

Gulpin -> Swalot

Numel -> Camerupt

Spoink -> Grumpig

Trapinch -> Vibrava -> Flygon

Cacnea -> Cacturne

Swablu -> Altaria

Barboach -> Whiscash

Corphish -> Crawdaunt

Feebas -> Milotic

Shuppet -> Banette

Duskull -> Dusclops -> Dusknoir

Snorunt -> Glalie, Froslass

Bagon -> Shelgon -> Salamence

Beldum -> Metang -> Metagross

Turtwig -> Grotle -> Torterra

Chimchar -> Monferno -> Infernape

Piplup -> Prinplup -> Empoleon

Starly -> Staravia -> Staraptor

Kricketot -> Kricketune

Shinx -> Luxio -> Luxray

Cranidos -> Rampardos

Shieldon -> Bastiodon

Combee -> Vespiquen

Buizel -> Floatzel

Shellos -> Gastrodon

Drifloon -> Drifblim

Chingling -> Chimecho

Stunky -> Skuntank

Bronzor -> Bronzong

Bonsly -> Sudowoodo

Gible -> Gabite -> Garchomp

Munchlax -> Snorlax

Riolu -> Lucario

Hippopotas -> Hippowdon

Croagunk -> Toxicroak

Finneon -> Lumineon

Snover -> Abomasnow

Snivy -> Servine -> Serperior

Tepig -> Pignite -> Emboar

Oshawott -> Dewott -> Samurott, Samurott-Hisui

Blitzle -> Zebstrika

Drilbur -> Excadrill

Timburr -> Gurdurr -> Conkeldurr

Sewaddle -> Swadloon -> Leavanny

Cottonee -> Whimsicott

Petilil -> Lilligant, Lilligant-Hisui

Basculin-White-Striped -> Basculegion, Basculegion-F

Sandile -> Krokorok -> Krookodile

Scraggy -> Scrafty

Zorua -> Zoroark

Zorua-Hisui -> Zoroark-Hisui

Minccino -> Cinccino

Gothita -> Gothorita -> Gothitelle

Solosis -> Duosion -> Reuniclus

Ducklett -> Swanna

Deerling -> Sawsbuck

Foongus -> Amoonguss

Joltik -> Galvantula

Tynamo -> Eelektrik -> Eelektross

Litwick -> Lampent -> Chandelure

Axew -> Fraxure -> Haxorus

Cubchoo -> Beartic

Mienfoo -> Mienshao

Golett -> Golurk

Pawniard -> Bisharp -> Kingambit

Rufflet -> Braviary, Braviary-Hisui

Vullaby -> Mandibuzz

Deino -> Zweilous -> Hydreigon

Larvesta -> Volcarona

Chespin -> Quilladin -> Chesnaught

Fennekin -> Braixen -> Delphox

Froakie -> Frogadier -> Greninja

Fletchling -> Fletchinder -> Talonflame

Scatterbug -> Spewpa -> Vivillon, Vivillon-Fancy

Litleo -> Pyroar

Flabebe -> Floette -> Florges

Skiddo -> Gogoat

Espurr -> Meowstic, Meowstic-F

Inkay -> Malamar

Skrelp -> Dragalge

Clauncher -> Clawitzer

Goomy -> Sliggoo -> Goodra
Goomy -> Sliggoo-Hisui -> Goodra-Hisui

Phantump -> Trevenant

Bergmite -> Avalugg, Avalugg-Hisui

Noibat -> Noivern

Rowlet -> Dartrix -> Decidueye, Decidueye-Hisui

Litten -> Torracat -> Incineroar

Popplio -> Brionne -> Primarina

Pikipek -> Trumbeak -> Toucannon

Yungoos -> Gumshoos

Grubbin -> Charjabug -> Vikavolt

Crabrawler -> Crabominable

Cutiefly -> Ribombee

Rockruff -> Lycanroc, Lycanroc-Midnight, Lycanroc-Dusk

Mareanie -> Toxapex

Mudbray -> Mudsdale

Dewpider -> Araquanid

Fomantis -> Lurantis

Salandit -> Salazzle

Bounsweet -> Steenee -> Tsareena

Sandygast -> Palossand

Jangmo-o -> Hakamo-o -> Kommo-o

Cosmog -> Cosmoem -> Solgaleo, Lunala

Grookey -> Thwackey -> Rillaboom

Scorbunny -> Raboot -> Cinderace

Sobble -> Drizzile -> Inteleon

Skwovet -> Greedent

Rookidee -> Corvisquire -> Corviknight

Chewtle -> Drednaw

Rolycoly -> Carkol -> Coalossal

Applin -> Dipplin -> Hydrapple
Applin -> Flapple, Appletun

Silicobra -> Sandaconda

Arrokuda -> Barraskewda

Toxel -> Toxtricity, Toxtricity-Low-Key

Sinistea -> Polteageist

Sinistea-Antique -> Polteageist-Antique

Hatenna -> Hattrem -> Hatterene

Impidimp -> Morgrem -> Grimmsnarl

Milcery -> Alcremie

Snom -> Frosmoth

Cufant -> Copperajah

Duraludon -> Archaludon

Dreepy -> Drakloak -> Dragapult

Kubfu -> Urshifu, Urshifu-Rapid-Strike

Sprigatito -> Floragato -> Meowscarada

Fuecoco -> Crocalor -> Skeledirge

Quaxly -> Quaxwell -> Quaquaval

Lechonk -> Oinkologne, Oinkologne-F

Tarountula -> Spidops

Nymble -> Lokix

Pawmi -> Pawmo -> Pawmot

Tandemaus -> Maushold, Maushold-Four

Fidough -> Dachsbun

Smoliv -> Dolliv -> Arboliva

Nacli -> Naclstack -> Garganacl

Charcadet -> Armarouge, Ceruledge

Tadbulb -> Bellibolt

Wattrel -> Kilowattrel

Maschiff -> Mabosstiff

Shroodle -> Grafaiai

Bramblin -> Brambleghast

Toedscool -> Toedscruel

Capsakid -> Scovillain

Rellor -> Rabsca

Flittle -> Espathra

Tinkatink -> Tinkatuff -> Tinkaton

Wiglett -> Wugtrio

Finizen -> Palafin

Varoom -> Revavroom

Glimmet -> Glimmora

Greavard -> Houndstone

Cetoddle -> Cetitan

Frigibax -> Arctibax -> Baxcalibur

Gimmighoul -> Gholdengo

Gimmighoul-Roaming -> Gholdengo

Poltchageist -> Sinistcha

Poltchageist-Artisan -> Sinistcha-Masterpiece

