Bulbasaur -> Ivysaur
Ivysaur -> Venusaur
Charmander -> Charmeleon
Charmeleon -> Charizard
Squirtle -> Wartortle
Wartortle -> Blastoise
Caterpie -> Metapod
Metapod -> Butterfree
Weedle -> Kakuna
Kakuna -> Beedrill
Pidgey -> Pidgeotto
Pidgeotto -> Pidgeot
Rattata -> Raticate
Spearow -> Fearow
Ekans -> Arbok
Pikachu -> Raichu, Raichu-Alola
Sandshrew -> Sandslash
Nidoran-F -> Nidorina
Nidorina -> Nidoqueen
Nidoran-M -> Nidorino
Nidorino -> Nidoking
Clefairy -> Clefable
Vulpix -> Ninetales
Jigglypuff -> Wigglytuff
Zubat -> Golbat
Golbat -> Crobat
Oddish -> Gloom
Gloom -> Vileplume, Bellossom
Paras -> Parasect
Venonat -> Venomoth
Diglett -> Dugtrio
Meowth -> Persian
Psyduck -> Golduck
Mankey -> Primeape
Primeape -> Annihilape
Growlithe -> Arcanine
Poliwag -> Poliwhirl
Poliwhirl -> Poliwrath, Politoed
Abra -> Kadabra
Kadabra -> Alakazam
Machop -> Machoke
Machoke -> Machamp
Bellsprout -> Weepinbell
Weepinbell -> Victreebel
Tentacool -> Tentacruel
Geodude -> Graveler
Graveler -> Golem
Ponyta -> Rapidash
Slowpoke -> Slowbro, Slowking
Magnemite -> Magneton
Magneton -> Magnezone
Doduo -> Dodrio
Seel -> Dewgong
Grimer -> Muk
Shellder -> Cloyster
Gastly -> Haunter
Haunter -> Gengar
Onix -> Steelix
Drowzee -> Hypno
Krabby -> Kingler
Voltorb -> Electrode
Exeggcute -> Exeggutor, Exeggutor-Alola
Cubone -> Marowak, Marowak-Alola
Lickitung -> Lickilicky
Koffing -> Weezing, Weezing-Galar
Rhyhorn -> Rhydon
Rhydon -> Rhyperior
Chansey -> Blissey
Tangela -> Tangrowth
Horsea -> Seadra
Seadra -> Kingdra
Goldeen -> Seaking
Staryu -> Starmie
Scyther -> Scizor, Kleavor
Electabuzz -> Electivire
Magmar -> Magmortar
Magikarp -> Gyarados
Eevee -> Vaporeon, Jolteon, Flareon, Espeon, Umbreon, Leafeon, Glaceon, Sylveon
Porygon -> Porygon2
Omanyte -> Omastar
Kabuto -> Kabutops
Dratini -> Dragonair
Dragonair -> Dragonite
Chikorita -> Bayleef
Bayleef -> Meganium
Cyndaquil -> Quilava
Quilava -> Typhlosion, Typhlosion-Hisui
Totodile -> Croconaw
Croconaw -> Feraligatr
Sentret -> Furret
Hoothoot -> Noctowl
Ledyba -> Ledian
Spinarak -> Ariados
Chinchou -> Lanturn
Pichu -> Pikachu
Cleffa -> Clefairy
Igglybuff -> Jigglypuff
Togepi -> Togetic
Togetic -> Togekiss
Natu -> Xatu
Mareep -> Flaaffy
Flaaffy -> Ampharos
Marill -> Azumarill
Hoppip -> Skiploom
Skiploom -> Jumpluff
Aipom -> Ambipom
Sunkern -> Sunflora
Yanma -> Yanmega
Wooper -> Quagsire
Murkrow -> Honchkrow
Misdreavus -> Mismagius
Girafarig -> Farigiraf
Pineco -> Forretress
Dunsparce -> Dudunsparce, Dudunsparce-Three-Segment
Gligar -> Gliscor
Snubbull -> Granbull
Sneasel -> Weavile
Teddiursa -> Ursaring
Ursaring -> Ursaluna
Slugma -> Magcargo
Swinub -> Piloswine
Piloswine -> Mamoswine
Remoraid -> Octillery
Houndour -> Houndoom
Phanpy -> Donphan
Porygon2 -> Porygon-Z
Stantler -> Wyrdeer
Tyrogue -> Hitmonlee, Hitmonchan, Hitmontop
Smoochum -> Jynx
Elekid -> Electabuzz
Magby -> Magmar
Larvitar -> Pupitar
Pupitar -> Tyranitar
Treecko -> Grovyle
Grovyle -> Sceptile
Torchic -> Combusken
Combusken -> Blaziken
Mudkip -> Marshtomp
Marshtomp -> Swampert
Poochyena -> Mightyena
Zigzagoon -> Linoone
Wurmple -> Silcoon, Cascoon
Silcoon -> Beautifly
Cascoon -> Dustox
Lotad -> Lombre
Lombre -> Ludicolo
Seedot -> Nuzleaf
Nuzleaf -> Shiftry
Taillow -> Swellow
Wingull -> Pelipper
Ralts -> Kirlia
Kirlia -> Gardevoir, Gallade
Surskit -> Masquerain
Shroomish -> Breloom
Slakoth -> Vigoroth
Vigoroth -> Slaking
Nincada -> Ninjask, Shedinja
Whismur -> Loudred
Loudred -> Exploud
Makuhita -> Hariyama
Azurill -> Marill
Nosepass -> Probopass
Skitty -> Delcatty
Aron -> Lairon
Lairon -> Aggron
Meditite -> Medicham
Electrike -> Manectric
Roselia -> Roserade
Gulpin -> Swalot
Carvanha -> Sharpedo
Wailmer -> Wailord
Numel -> Camerupt
Spoink -> Grumpig
Trapinch -> Vibrava
Vibrava -> Flygon
Cacnea -> Cacturne
Swablu -> Altaria
Barboach -> Whiscash
Corphish -> Crawdaunt
Baltoy -> Claydol
Lileep -> Cradily
Anorith -> Armaldo
Feebas -> Milotic
Shuppet -> Banette
Duskull -> Dusclops
Dusclops -> Dusknoir
Wynaut -> Wobbuffet
Snorunt -> Glalie, Froslass
Spheal -> Sealeo
Sealeo -> Walrein
Clamperl -> Huntail, Gorebyss
Bagon -> Shelgon
Shelgon -> Salamence
Beldum -> Metang
Metang -> Metagross
Turtwig -> Grotle
Grotle -> Torterra
Chimchar -> Monferno
Monferno -> Infernape
Piplup -> Prinplup
Prinplup -> Empoleon
Starly -> Staravia
Staravia -> Staraptor
Bidoof -> Bibarel
Kricketot -> Kricketune
Shinx -> Luxio
Luxio -> Luxray
Budew -> Roselia
Cranidos -> Rampardos
Shieldon -> Bastiodon
Burmy -> Wormadam, Wormadam-Sandy, Wormadam-Trash, Mothim
Combee -> Vespiquen
Buizel -> Floatzel
Cherubi -> Cherrim
Shellos -> Gastrodon
Drifloon -> Drifblim
Buneary -> Lopunny
Glameow -> Purugly
Chingling -> Chimecho
Stunky -> Skuntank
Bronzor -> Bronzong
Bonsly -> Sudowoodo
Mime Jr. -> Mr. Mime, Mr. Mime-Galar
Happiny -> Chansey
Gible -> Gabite
Gabite -> Garchomp
Munchlax -> Snorlax
Riolu -> Lucario
Hippopotas -> Hippowdon
Skorupi -> Drapion
Croagunk -> Toxicroak
Finneon -> Lumineon
Mantyke -> Mantine
Snover -> Abomasnow
Snivy -> Servine
Servine -> Serperior
Tepig -> Pignite
Pignite -> Emboar
Oshawott -> Dewott
Dewott -> Samurott, Samurott-Hisui
Patrat -> Watchog
Lillipup -> Herdier
Herdier -> Stoutland
Purrloin -> Liepard
Pansage -> Simisage
Pansear -> Simisear
Panpour -> Simipour
Munna -> Musharna
Pidove -> Tranquill
Tranquill -> Unfezant
Blitzle -> Zebstrika
Roggenrola -> Boldore
Boldore -> Gigalith
Woobat -> Swoobat
Drilbur -> Excadrill
Timburr -> Gurdurr
Gurdurr -> Conkeldurr
Tympole -> Palpitoad
Palpitoad -> Seismitoad
Sewaddle -> Swadloon
Swadloon -> Leavanny
Venipede -> Whirlipede
Whirlipede -> Scolipede
Cottonee -> Whimsicott
Petilil -> Lilligant, Lilligant-Hisui
Sandile -> Krokorok
Krokorok -> Krookodile
Darumaka -> Darmanitan
Dwebble -> Crustle
Scraggy -> Scrafty
Yamask -> Cofagrigus
Tirtouga -> Carracosta
Archen -> Archeops
Trubbish -> Garbodor
Zorua -> Zoroark
Minccino -> Cinccino
Gothita -> Gothorita
Gothorita -> Gothitelle
Solosis -> Duosion
Duosion -> Reuniclus
Ducklett -> Swanna
Vanillite -> Vanillish
Vanillish -> Vanilluxe
Deerling -> Sawsbuck
Karrablast -> Escavalier
Foongus -> Amoonguss
Frillish -> Jellicent
Joltik -> Galvantula
Ferroseed -> Ferrothorn
Klink -> Klang
Klang -> Klinklang
Tynamo -> Eelektrik
Eelektrik -> Eelektross
Elgyem -> Beheeyem
Litwick -> Lampent
Lampent -> Chandelure
Axew -> Fraxure
Fraxure -> Haxorus
Cubchoo -> Beartic
Shelmet -> Accelgor
Mienfoo -> Mienshao
Golett -> Golurk
Pawniard -> Bisharp
Bisharp -> Kingambit
Rufflet -> Braviary, Braviary-Hisui
Vullaby -> Mandibuzz
Deino -> Zweilous
Zweilous -> Hydreigon
Larvesta -> Volcarona
