Bulbasaur -> Ivysaur -> Venusaur

Charmander -> Charmeleon -> Charizard

Squirtle -> Wartortle -> Blastoise

Caterpie -> Metapod -> Butterfree

Pichu -> Pikachu -> Raichu, Raichu-Alola

Sandshrew -> Sandslash

Sandshrew-Alola -> Sandslash-Alola

Nidoran-F -> Nidorina -> Nidoqueen

Nidoran-M -> Nidorino -> Nidoking

Cleffa -> Clefairy -> Clefable

Vulpix -> Ninetales

Vulpix-Alola -> Ninetales-Alola

Igglybuff -> Jigglypuff -> Wigglytuff

Zubat -> Golbat -> Crobat

Oddish -> Gloom -> Vileplume, Bellossom

Diglett -> Dugtrio

Diglett-Alola -> Dugtrio-Alola

Meowth -> Persian

Meowth-Alola -> Persian-Alola

Meowth-Galar -> Perrserker

Psyduck -> Golduck

Growlithe -> Arcanine

Poliwag -> Poliwhirl -> Poliwrath, Politoed

Abra -> Kadabra -> Alakazam

Machop -> Machoke -> Machamp

Tentacool -> Tentacruel

Ponyta -> Rapidash

Ponyta-Galar -> Rapidash-Galar

Slowpoke -> Slowbro, Slowking

Slowpoke-Galar -> Slowbro-Galar, Slowking-Galar

Magnemite -> Magneton -> Magnezone

Farfetch'd

Farfetch'd-Galar -> Sirfetch'd

Shellder -> Cloyster

Gastly -> Haunter -> Gengar

Onix -> Steelix

Krabby -> Kingler

Exeggcute -> Exeggutor, Exeggutor-Alola

Cubone -> Marowak, Marowak-Alola

Tyrogue -> Hitmonlee, Hitmonchan, Hitmontop

Lickitung -> Lickilicky

Koffing -> Weezing, Weezing-Galar

Rhyhorn -> Rhydon -> Rhyperior

Happiny -> Chansey -> Blissey

Tangela -> Tangrowth

Kangaskhan

Horsea -> Seadra -> Kingdra

Goldeen -> Seaking

Staryu -> Starmie

Mime Jr. -> Mr. Mime-Galar -> Mr. Rime
Mime Jr. -> Mr. Mime

Scyther -> Scizor

Smoochum -> Jynx

Elekid -> Electabuzz -> Electivire

Magby -> Magmar -> Magmortar

Pinsir

Tauros

Magikarp -> Gyarados

Lapras

Ditto

Eevee -> Vaporeon, Jolteon, Flareon, Espeon, Umbreon, Leafeon, Glaceon, Sylveon

Porygon -> Porygon2 -> Porygon-Z

Omanyte -> Omastar

Kabuto -> Kabutops

Aerodactyl

Munchlax -> Snorlax

Articuno

Zapdos

Moltres

Dratini -> Dragonair -> Dragonite

Mewtwo

Mew

Hoothoot -> Noctowl

Chinchou -> Lanturn

Togepi -> Togetic -> Togekiss

Natu -> Xatu

Azurill -> Marill -> Azumarill

Bonsly -> Sudowoodo

Wooper -> Quagsire

Wynaut -> Wobbuffet

Dunsparce

Qwilfish

Shuckle

Heracross

Sneasel -> Weavile

Swinub -> Piloswine -> Mamoswine

Corsola

Corsola-Galar -> Cursola

Remoraid -> Octillery

Delibird

Mantyke -> Mantine

Skarmory

Miltank

Raikou

Entei

Suicune

Larvitar -> Pupitar -> Tyranitar

Lugia

Ho-Oh

Celebi

Treecko -> Grovyle -> Sceptile

Torchic -> Combusken -> Blaziken

Mudkip -> Marshtomp -> Swampert

Zigzagoon -> Linoone

Zigzagoon-Galar -> Linoone-Galar -> Obstagoon

Lotad -> Lombre -> Ludicolo

Seedot -> Nuzleaf -> Shiftry

Wingull -> Pelipper

Ralts -> Kirlia -> Gardevoir, Gallade

Nincada -> Ninjask, Shedinja

Whismur -> Loudred -> Exploud

Sableye

Mawile

Aron -> Lairon -> Aggron

Electrike -> Manectric

Budew -> Roselia -> Roserade

Carvanha -> Sharpedo

Wailmer -> Wailord

Torkoal

Trapinch -> Vibrava -> Flygon

Swablu -> Altaria

Lunatone

Solrock

Barboach -> Whiscash

Corphish -> Crawdaunt

Baltoy -> Claydol

Lileep -> Cradily

Anorith -> Armaldo

Feebas -> Milotic

Duskull -> Dusclops -> Dusknoir

Absol

Snorunt -> Glalie, Froslass

Spheal -> Sealeo -> Walrein

Relicanth

Bagon -> Shelgon -> Salamence

Beldum -> Metang -> Metagross

Regirock

Regice

Registeel

Latias

Latios

Kyogre

Groudon

Rayquaza

Jirachi

Shinx -> Luxio -> Luxray

Combee -> Vespiquen

Cherubi -> Cherrim

Shellos -> Gastrodon

Drifloon -> Drifblim

Buneary -> Lopunny

Stunky -> Skuntank

Bronzor -> Bronzong

Spiritomb

Gible -> Gabite -> Garchomp

Riolu -> Lucario

Hippopotas -> Hippowdon

Skorupi -> Drapion

Croagunk -> Toxicroak

Snover -> Abomasnow

Rotom

Uxie

Mesprit

Azelf

Dialga

Palkia

Heatran

Regigigas

Giratina

Cresselia

Victini

Lillipup -> Herdier -> Stoutland

Purrloin -> Liepard

Munna -> Musharna

Pidove -> Tranquill -> Unfezant

Roggenrola -> Boldore -> Gigalith

Woobat -> Swoobat

Drilbur -> Excadrill

Audino

Timburr -> Gurdurr -> Conkeldurr

Tympole -> Palpitoad -> Seismitoad

Throh

Sawk

Venipede -> Whirlipede -> Scolipede

Cottonee -> Whimsicott

Petilil -> Lilligant

Basculin

Sandile -> Krokorok -> Krookodile

Darumaka -> Darmanitan

Darumaka-Galar -> Darmanitan-Galar

Maractus

Dwebble -> Crustle

Scraggy -> Scrafty

Sigilyph

Yamask -> Cofagrigus

Yamask-Galar -> Runerigus

Tirtouga -> Carracosta

Archen -> Archeops

Trubbish -> Garbodor

Zorua -> Zoroark

Minccino -> Cinccino

Gothita -> Gothorita -> Gothitelle

Solosis -> Duosion -> Reuniclus

Vanillite -> Vanillish -> Vanilluxe

Emolga

Karrablast -> Escavalier

Foongus -> Amoonguss

Frillish -> Jellicent

Joltik -> Galvantula

Ferroseed -> Ferrothorn

Klink -> Klang -> Klinklang

Elgyem -> Beheeyem

Litwick -> Lampent -> Chandelure

Axew -> Fraxure -> Haxorus

Cubchoo -> Beartic

Cryogonal

Shelmet -> Accelgor

Stunfisk

Mienfoo -> Mienshao

Druddigon

Golett -> Golurk

Pawniard -> Bisharp

Bouffalant

Rufflet -> Braviary

Vullaby -> Mandibuzz

Heatmor

Durant

Deino -> Zweilous -> Hydreigon

Larvesta -> Volcarona

Cobalion

Terrakion

Virizion

Tornadus

Thundurus

Reshiram

Zekrom

Landorus

Kyurem

Keldeo

Genesect

Bunnelby -> Diggersby

Fletchling -> Fletchinder -> Talonflame

Pancham -> Pangoro

Espurr -> Meowstic, Meowstic-F

Honedge -> Doublade -> Aegislash

Spritzee -> Aromatisse

Swirlix -> Slurpuff

Inkay -> Malamar

Binacle -> Barbaracle

Skrelp -> Dragalge

Clauncher -> Clawitzer

Helioptile -> Heliolisk

Tyrunt -> Tyrantrum

Amaura -> Aurorus

Hawlucha

Dedenne

Carbink

Goomy -> Sliggoo -> Goodra

Klefki

Phantump -> Trevenant

Pumpkaboo -> Gourgeist

Pumpkaboo-Small -> Gourgeist-Small

Pumpkaboo-Large -> Gourgeist-Large

Pumpkaboo-Super -> Gourgeist-Super

Bergmite -> Avalugg

Noibat -> Noivern

Xerneas

Yveltal

Zygarde

Diancie

Volcanion

Rowlet -> Dartrix -> Decidueye

Litten -> Torracat -> Incineroar

Popplio -> Brionne -> Primarina

Grubbin -> Charjabug -> Vikavolt

Cutiefly -> Ribombee

Rockruff -> Lycanroc, Lycanroc-Midnight, Lycanroc-Dusk

Wishiwashi

Mareanie -> Toxapex

Mudbray -> Mudsdale

Dewpider -> Araquanid

Fomantis -> Lurantis

Morelull -> Shiinotic

Salandit -> Salazzle

Stufful -> Bewear

Bounsweet -> Steenee -> Tsareena

Comfey

Oranguru

Passimian

Wimpod -> Golisopod

Sandygast -> Palossand

Pyukumuku

Type: Null -> Silvally

Turtonator

Togedemaru

Mimikyu

Drampa

Dhelmise

Jangmo-o -> Hakamo-o -> Kommo-o

Tapu Koko

Tapu Lele

Tapu Bulu

Tapu Fini

Cosmog -> Cosmoem -> Solgaleo, Lunala

Nihilego

Buzzwole

Pheromosa

Xurkitree

Celesteela

Kartana

Guzzlord

Necrozma

Magearna

Marshadow

Poipole -> Naganadel

Stakataka

Blacephalon

Zeraora

Meltan

Melmetal

Grookey -> Thwackey -> Rillaboom

Scorbunny -> Raboot -> Cinderace

Sobble -> Drizzile -> Inteleon

Skwovet -> Greedent

Rookidee -> Corvisquire -> Corviknight

Blipbug -> Dottler -> Orbeetle

Nickit -> Thievul

Gossifleur -> Eldegoss

Wooloo -> Dubwool

Chewtle -> Drednaw

Yamper -> Boltund

Rolycoly -> Carkol -> Coalossal

Applin -> Flapple, Appletun

Silicobra -> Sandaconda

Cramorant

Arrokuda -> Barraskewda

Toxel -> Toxtricity, Toxtricity-Low-Key

Sizzlipede -> Centiskorch

Clobbopus -> Grapploct

Sinistea -> Polteageist

Sinistea-Antique -> Polteageist-Antique

Hatenna -> Hattrem -> Hatterene

Impidimp -> Morgrem -> Grimmsnarl

Milcery -> Alcremie

Falinks

Pincurchin

Snom -> Frosmoth

Stonjourner

Eiscue

Indeedee

Morpeko

Cufant -> Copperajah

Dracozolt

Arctozolt

Dracovish

Arctovish

Duraludon

Dreepy -> Drakloak -> Dragapult

Zacian

Zamazenta

Eternatus

Kubfu -> Urshifu, Urshifu-Rapid-Strike

Zarude

Regieleki

Regidrago

Glastrier

Spectrier

Calyrex

