Bulbasaur (妙蛙种子) -> Ivysaur (妙蛙草) -> Venusaur (妙蛙花)

Charmander (小火龙) -> Charmeleon (火恐龙) -> Charizard (喷火龙)

Squirtle (杰尼龟) -> Wartortle (卡咪龟) -> Blastoise (水箭龟)

Caterpie (绿毛虫) -> Metapod (铁甲蛹) -> Butterfree (巴大蝶)

Weedle (独角虫) -> Kakuna (铁壳蛹) -> Beedrill (大针蜂)

Pidgey (波波) -> Pidgeotto (比比鸟) -> Pidgeot (大比鸟)

Rattata (小拉达) -> Raticate (拉达)

Spearow (烈雀) -> Fearow (大嘴雀)

Ekans (阿柏蛇) -> Arbok (阿柏怪)

Pichu (皮丘) -> Pikachu (皮卡丘) -> Raichu (雷丘)

Sandshrew (穿山鼠) -> Sandslash (穿山王)

Nidoran-F (尼多兰) -> Nidorina (尼多娜) -> Nidoqueen (尼多后)

Nidoran-M (尼多朗) -> Nidorino (尼多力诺) -> Nidoking (尼多王)

Cleffa (皮宝宝) -> Clefairy (皮皮) -> Clefable (皮可西)

Vulpix (六尾) -> Ninetales (九尾)

Igglybuff (宝宝丁) -> Jigglypuff (胖丁) -> Wigglytuff (胖可丁)

Zubat (超音蝠) -> Golbat (大嘴蝠) -> Crobat (叉字蝠)

Oddish (走路草) -> Gloom (臭臭花) -> Vileplume (霸王花), Bellossom (美丽花)

Paras (派拉斯) -> Parasect (派拉斯特)

Venonat (毛球) -> Venomoth (摩鲁蛾)

Diglett (地鼠) -> Dugtrio (三地鼠)

Meowth (喵喵) -> Persian (猫老大)

Psyduck (可达鸭) -> Golduck (哥达鸭)

Mankey (猴怪) -> Primeape (火暴猴)

Growlithe (卡蒂狗) -> Arcanine (风速狗)

Poliwag (蚊香蝌蚪) -> Poliwhirl (蚊香君) -> Poliwrath (蚊香泳士), Politoed (蚊香蛙皇)

Abra (凯西) -> Kadabra (勇基拉) -> Alakazam (胡地)

Machop (腕力) -> Machoke (豪力) -> Machamp (怪力)

Bellsprout (喇叭芽) -> Weepinbell (口呆花) -> Victreebel (大食花)

Tentacool (玛瑙水母) -> Tentacruel (毒刺水母)

Geodude (小拳石) -> Graveler (隆隆石) -> Golem (隆隆岩)

Ponyta (小火马) -> Rapidash (烈焰马)

Slowpoke (呆呆兽) -> Slowbro (呆壳兽), Slowking (呆呆王)

Magnemite (小磁怪) -> Magneton (三合一磁怪)

Farfetch'd (大葱鸭)

Doduo (嘟嘟) -> Dodrio (嘟嘟利)

Seel (小海狮) -> Dewgong (白海狮)

Grimer (臭泥) -> Muk (臭臭泥)

Shellder (大舌贝) -> Cloyster (刺甲贝)

Gastly (鬼斯) -> Haunter (鬼斯通) -> Gengar (耿鬼)

Onix (大岩蛇) -> Steelix (大钢蛇)

Drowzee (催眠貘) -> Hypno (引梦貘人)

Krabby (大钳蟹) -> Kingler (巨钳蟹)

Voltorb (霹雳电球) -> Electrode (顽皮雷弹)

Exeggcute (蛋蛋) -> Exeggutor (椰蛋树)

Cubone (卡拉卡拉) -> Marowak (嘎啦嘎啦)

Tyrogue (无畏小子) -> Hitmonlee (飞腿郎), Hitmonchan (快拳郎), Hitmontop (战舞郎)

Lickitung (大舌头)

Koffing (瓦斯弹) -> Weezing (双弹瓦斯)

Rhyhorn (独角犀牛) -> Rhydon (钻角犀兽)

Chansey (吉利蛋) -> Blissey (幸福蛋)

Tangela (蔓藤怪)

Kangaskhan (袋兽)

Horsea (墨海马) -> Seadra (海刺龙) -> Kingdra (刺龙王)

Goldeen (角金鱼) -> Seaking (金鱼王)

Staryu (海星星) -> Starmie (宝石海星)

Mr. Mime (魔墙人偶)

Scyther (飞天螳螂) -> Scizor (巨钳螳螂)

Smoochum (迷唇娃) -> Jynx (迷唇姐)

Elekid (电击怪) -> Electabuzz (电击兽)

Magby (鸭嘴宝宝) -> Magmar (鸭嘴火兽)

Pinsir (凯罗斯)

Tauros (肯泰罗)

Magikarp (鲤鱼王) -> Gyarados (暴鲤龙)

Lapras (拉普拉斯)

Ditto (百变怪)

Eevee (伊布) -> Vaporeon (水伊布), Jolteon (雷伊布), Flareon (火伊布), Espeon (太阳伊布), Umbreon (月亮伊布)

Porygon (多边兽) -> Porygon2 (多边兽２型)

Omanyte (菊石兽) -> Omastar (多刺菊石兽)

Kabuto (化石盔) -> Kabutops (镰刀盔)

Aerodactyl (化石翼龙)

Snorlax (卡比兽)

Articuno (急冻鸟)

Zapdos (闪电鸟)

Moltres (火焰鸟)

Dratini (迷你龙) -> Dragonair (哈克龙) -> Dragonite (快龙)

Mewtwo (超梦)

Mew (梦幻)

Chikorita (菊草叶) -> Bayleef (月桂叶) -> Meganium (大竺葵)

Cyndaquil (火球鼠) -> Quilava (火岩鼠) -> Typhlosion (火暴兽)

Totodile (小锯鳄) -> Croconaw (蓝鳄) -> Feraligatr (大力鳄)

Sentret (尾立) -> Furret (大尾立)

Hoothoot (咕咕) -> Noctowl (猫头夜鹰)

Ledyba (芭瓢虫) -> Ledian (安瓢虫)

Spinarak (圆丝蛛) -> Ariados (阿利多斯)

Chinchou (灯笼鱼) -> Lanturn (电灯怪)

Togepi (波克比) -> Togetic (波克基古)

Natu (天然雀) -> Xatu (天然鸟)

Mareep (咩利羊) -> Flaaffy (茸茸羊) -> Ampharos (电龙)

Marill (玛力露) -> Azumarill (玛力露丽)

Sudowoodo (树才怪)

Hoppip (毽子草) -> Skiploom (毽子花) -> Jumpluff (毽子棉)

Aipom (长尾怪手)

Sunkern (向日种子) -> Sunflora (向日花怪)

Yanma (蜻蜻蜓)

Wooper (乌波) -> Quagsire (沼王)

Murkrow (黑暗鸦)

Misdreavus (梦妖)

Unown (未知图腾)

Wobbuffet (果然翁)

Girafarig (麒麟奇)

Pineco (榛果球) -> Forretress (佛烈托斯)

Dunsparce (土龙弟弟)

Gligar (天蝎)

Snubbull (布鲁) -> Granbull (布鲁皇)

Qwilfish (千针鱼)

Shuckle (壶壶)

Heracross (赫拉克罗斯)

Sneasel (狃拉)

Teddiursa (熊宝宝) -> Ursaring (圈圈熊)

Slugma (熔岩虫) -> Magcargo (熔岩蜗牛)

Swinub (小山猪) -> Piloswine (长毛猪)

Corsola (太阳珊瑚)

Remoraid (铁炮鱼) -> Octillery (章鱼桶)

Delibird (信使鸟)

Mantine (巨翅飞鱼)

Skarmory (盔甲鸟)

Houndour (戴鲁比) -> Houndoom (黑鲁加)

Phanpy (小小象) -> Donphan (顿甲)

Stantler (惊角鹿)

Smeargle (图图犬)

Miltank (大奶罐)

Raikou (雷公)

Entei (炎帝)

Suicune (水君)

Larvitar (幼基拉斯) -> Pupitar (沙基拉斯) -> Tyranitar (班基拉斯)

Lugia (洛奇亚)

Ho-Oh (凤王)

Celebi (时拉比)
