Bulbasaur -> Ivysaur -> Venusaur

Charmander -> Charmeleon -> Charizard

Squirtle -> Wartortle -> Blastoise

Caterpie -> Metapod -> Butterfree

Weedle -> Kakuna -> Beedrill

Pidgey -> Pidgeotto -> Pidgeot

Rattata -> Raticate

Spearow -> Fearow

Ekans -> Arbok

Pichu -> Pikachu -> Raichu

Sandshrew -> Sandslash

Nidoran-F -> Nidorina -> Nidoqueen

Nidoran-M -> Nidorino -> Nidoking

Cleffa -> Clefairy -> Clefable

Vulpix -> Ninetales

Igglybuff -> Jigglypuff -> Wigglytuff

Zubat -> Golbat -> Crobat

Oddish -> Gloom -> Vileplume, Bellossom

Paras -> Parasect

Venonat -> Venomoth

Diglett -> Dugtrio

Meowth -> Persian

Psyduck -> Golduck

Mankey -> Primeape

Growlithe -> Arcanine

Poliwag -> Poliwhirl -> Poliwrath, Politoed

Abra -> Kadabra -> Alakazam

Machop -> Machoke -> Machamp

Bellsprout -> Weepinbell -> Victreebel

Tentacool -> Tentacruel

Geodude -> Graveler -> Golem

Ponyta -> Rapidash

Slowpoke -> Slowbro, Slowking

Magnemite -> Magneton -> Magnezone

Farfetch'd

Doduo -> Dodrio

Seel -> Dewgong

Grimer -> Muk

Shellder -> Cloyster

Gastly -> Haunter -> Gengar

Onix -> Steelix

Drowzee -> Hypno

Krabby -> Kingler

Voltorb -> Electrode

Exeggcute -> Exeggutor

Cubone -> Marowak

Tyrogue -> Hitmonlee, Hitmonchan, Hitmontop

Lickitung -> Lickilicky

Koffing -> Weezing

Rhyhorn -> Rhydon -> Rhyperior

Happiny -> Chansey -> Blissey

Tangela -> Tangrowth

Kangaskhan

Horsea -> Seadra -> Kingdra

Goldeen -> Seaking

Staryu -> Starmie

Mime Jr. -> Mr. Mime

Scyther -> Scizor

Smoochum -> Jynx

Elekid -> Electabuzz -> Electivire

Magby -> Magmar -> Magmortar

Pinsir

Tauros

Magikarp -> Gyarados

Lapras

Ditto

Eevee -> Vaporeon, Jolteon, Flareon, Espeon, Umbreon, Leafeon, Glaceon

Porygon -> Porygon2 -> Porygon-Z

Omanyte -> Omastar

Kabuto -> Kabutops

Aerodactyl

Munchlax -> Snorlax

Articuno

Zapdos

Moltres

Dratini -> Dragonair -> Dragonite

Mewtwo

Mew

Chikorita -> Bayleef -> Meganium

Cyndaquil -> Quilava -> Typhlosion

Totodile -> Croconaw -> Feraligatr

Sentret -> Furret

Hoothoot -> Noctowl

Ledyba -> Ledian

Spinarak -> Ariados

Chinchou -> Lanturn

Togepi -> Togetic -> Togekiss

Natu -> Xatu

Mareep -> Flaaffy -> Ampharos

Azurill -> Marill -> Azumarill

Bonsly -> Sudowoodo

Hoppip -> Skiploom -> Jumpluff

Aipom -> Ambipom

Sunkern -> Sunflora

Yanma -> Yanmega

Wooper -> Quagsire

Murkrow -> Honchkrow

Misdreavus -> Mismagius

Unown

Wynaut -> Wobbuffet

Girafarig

Pineco -> Forretress

Dunsparce

Gligar -> Gliscor

Snubbull -> Granbull

Qwilfish

Shuckle

Heracross

Sneasel -> Weavile

Teddiursa -> Ursaring

Slugma -> Magcargo

Swinub -> Piloswine -> Mamoswine

Corsola

Remoraid -> Octillery

Delibird

Mantyke -> Mantine

Skarmory

Houndour -> Houndoom

Phanpy -> Donphan

Stantler

Smeargle

Miltank

Raikou

Entei

Suicune

Larvitar -> Pupitar -> Tyranitar

Lugia

Ho-Oh

Celebi

Treecko -> Grovyle -> Sceptile

Torchic -> Combusken -> Blaziken

Mudkip -> Marshtomp -> Swampert

Poochyena -> Mightyena

Zigzagoon -> Linoone

Wurmple -> Silcoon -> Beautifly
Wurmple -> Cascoon -> Dustox

Lotad -> Lombre -> Ludicolo

Seedot -> Nuzleaf -> Shiftry

Taillow -> Swellow

Wingull -> Pelipper

Ralts -> Kirlia -> Gardevoir, Gallade

Surskit -> Masquerain

Shroomish -> Breloom

Slakoth -> Vigoroth -> Slaking

Nincada -> Ninjask, Shedinja

Whismur -> Loudred -> Exploud

Makuhita -> Hariyama

Nosepass -> Probopass

Skitty -> Delcatty

Sableye

Mawile

Aron -> Lairon -> Aggron

Meditite -> Medicham

Electrike -> Manectric

Plusle

Minun

Volbeat

Illumise

Budew -> Roselia -> Roserade

Gulpin -> Swalot

Carvanha -> Sharpedo

Wailmer -> Wailord

Numel -> Camerupt

Torkoal

Spoink -> Grumpig

Spinda

Trapinch -> Vibrava -> Flygon

Cacnea -> Cacturne

Swablu -> Altaria

Zangoose

Seviper

Lunatone

Solrock

Barboach -> Whiscash

Corphish -> Crawdaunt

Baltoy -> Claydol

Lileep -> Cradily

Anorith -> Armaldo

Feebas -> Milotic

Castform

Kecleon

Shuppet -> Banette

Duskull -> Dusclops -> Dusknoir

Tropius

Chingling -> Chimecho

Absol

Snorunt -> Glalie, Froslass

Spheal -> Sealeo -> Walrein

Clamperl -> Huntail, Gorebyss

Relicanth

Luvdisc

Bagon -> Shelgon -> Salamence

Beldum -> Metang -> Metagross

Regirock

Regice

Registeel

Latias

Latios

Kyogre

Groudon

Rayquaza

Jirachi

Deoxys

Turtwig -> Grotle -> Torterra

Chimchar -> Monferno -> Infernape

Piplup -> Prinplup -> Empoleon

Starly -> Staravia -> Staraptor

Bidoof -> Bibarel

Kricketot -> Kricketune

Shinx -> Luxio -> Luxray

Cranidos -> Rampardos

Shieldon -> Bastiodon

Burmy -> Wormadam, Wormadam-Sandy, Wormadam-Trash, Mothim

Combee -> Vespiquen

Pachirisu

Buizel -> Floatzel

Cherubi -> Cherrim

Shellos -> Gastrodon

Drifloon -> Drifblim

Buneary -> Lopunny

Glameow -> Purugly

Stunky -> Skuntank

Bronzor -> Bronzong

Chatot

Spiritomb

Gible -> Gabite -> Garchomp

Riolu -> Lucario

Hippopotas -> Hippowdon

Skorupi -> Drapion

Croagunk -> Toxicroak

Carnivine

Finneon -> Lumineon

Snover -> Abomasnow

Rotom

Uxie

Mesprit

Azelf

Dialga

Palkia

Heatran

Regigigas

Giratina

Cresselia

Phione

Manaphy

Darkrai

Shaymin

Arceus

