Bulbasaur (妙蛙种子) -> Ivysaur (妙蛙草) -> Venusaur (妙蛙花)

Charmander (小火龙) -> Charmeleon (火恐龙) -> Charizard (喷火龙)

Squirtle (杰尼龟) -> Wartortle (卡咪龟) -> Blastoise (水箭龟)

Ekans (阿柏蛇) -> Arbok (阿柏怪)

Pichu (皮丘) -> Pikachu (皮卡丘) -> Raichu (雷丘), Raichu-Alola

Sandshrew (穿山鼠) -> Sandslash (穿山王)

Sandshrew-Alola -> Sandslash-Alola

Cleffa (皮宝宝) -> Clefairy (皮皮) -> Clefable (皮可西)

Vulpix (六尾) -> Ninetales (九尾)

Vulpix-Alola -> Ninetales-Alola

Igglybuff (宝宝丁) -> Jigglypuff (胖丁) -> Wigglytuff (胖可丁)

Oddish (走路草) -> Gloom (臭臭花) -> Vileplume (霸王花), Bellossom (美丽花)

Venonat (毛球) -> Venomoth (摩鲁蛾)

Diglett (地鼠) -> Dugtrio (三地鼠)

Diglett-Alola -> Dugtrio-Alola

Meowth (喵喵) -> Persian (猫老大)

Meowth-Alola -> Persian-Alola

Meowth-Galar -> Perrserker (喵头目)

Psyduck (可达鸭) -> Golduck (哥达鸭)

Mankey (猴怪) -> Primeape (火暴猴) -> Annihilape (弃世猴)

Growlithe (卡蒂狗) -> Arcanine (风速狗)

Growlithe-Hisui -> Arcanine-Hisui

Poliwag (蚊香蝌蚪) -> Poliwhirl (蚊香君) -> Poliwrath (蚊香泳士), Politoed (蚊香蛙皇)

Bellsprout (喇叭芽) -> Weepinbell (口呆花) -> Victreebel (大食花)

Tentacool (玛瑙水母) -> Tentacruel (毒刺水母)

Geodude (小拳石) -> Graveler (隆隆石) -> Golem (隆隆岩)

Geodude-Alola -> Graveler-Alola -> Golem-Alola

Slowpoke (呆呆兽) -> Slowbro (呆壳兽), Slowking (呆呆王)

Slowpoke-Galar -> Slowbro-Galar, Slowking-Galar

Magnemite (小磁怪) -> Magneton (三合一磁怪) -> Magnezone (自爆磁怪)

Doduo (嘟嘟) -> Dodrio (嘟嘟利)

Seel (小海狮) -> Dewgong (白海狮)

Grimer (臭泥) -> Muk (臭臭泥)

Grimer-Alola -> Muk-Alola

Shellder (大舌贝) -> Cloyster (刺甲贝)

Gastly (鬼斯) -> Haunter (鬼斯通) -> Gengar (耿鬼)

Drowzee (催眠貘) -> Hypno (引梦貘人)

Voltorb (霹雳电球) -> Electrode (顽皮雷弹)

Voltorb-Hisui -> Electrode-Hisui

Exeggcute (蛋蛋) -> Exeggutor (椰蛋树), Exeggutor-Alola

Tyrogue (无畏小子) -> Hitmonlee (飞腿郎), Hitmonchan (快拳郎), Hitmontop (战舞郎)

Koffing (瓦斯弹) -> Weezing (双弹瓦斯), Weezing-Galar

Rhyhorn (独角犀牛) -> Rhydon (钻角犀兽) -> Rhyperior (超甲狂犀)

Happiny (小福蛋) -> Chansey (吉利蛋) -> Blissey (幸福蛋)

Horsea (墨海马) -> Seadra (海刺龙) -> Kingdra (刺龙王)

Scyther (飞天螳螂) -> Scizor (巨钳螳螂), Kleavor (劈斧螳螂)

Elekid (电击怪) -> Electabuzz (电击兽) -> Electivire (电击魔兽)

Magby (鸭嘴宝宝) -> Magmar (鸭嘴火兽) -> Magmortar (鸭嘴炎兽)

Tauros (肯泰罗)

Magikarp (鲤鱼王) -> Gyarados (暴鲤龙)

Lapras (拉普拉斯)

Ditto (百变怪)

Eevee (伊布) -> Vaporeon (水伊布), Jolteon (雷伊布), Flareon (火伊布), Espeon (太阳伊布), Umbreon (月亮伊布), Leafeon (叶伊布), Glaceon (冰伊布), Sylveon (仙子伊布)

Porygon (多边兽) -> Porygon2 (多边兽２型) -> Porygon-Z (多边兽乙型)

Munchlax (小卡比兽) -> Snorlax (卡比兽)

Articuno (急冻鸟)

Zapdos (闪电鸟)

Moltres (火焰鸟)

Dratini (迷你龙) -> Dragonair (哈克龙) -> Dragonite (快龙)

Mewtwo (超梦)

Mew (梦幻)

Chikorita (菊草叶) -> Bayleef (月桂叶) -> Meganium (大竺葵)

Cyndaquil (火球鼠) -> Quilava (火岩鼠) -> Typhlosion (火暴兽), Typhlosion-Hisui

Totodile (小锯鳄) -> Croconaw (蓝鳄) -> Feraligatr (大力鳄)

Sentret (尾立) -> Furret (大尾立)

Hoothoot (咕咕) -> Noctowl (猫头夜鹰)

Spinarak (圆丝蛛) -> Ariados (阿利多斯)

Chinchou (灯笼鱼) -> Lanturn (电灯怪)

Mareep (咩利羊) -> Flaaffy (茸茸羊) -> Ampharos (电龙)

Azurill (露力丽) -> Marill (玛力露) -> Azumarill (玛力露丽)

Bonsly (盆才怪) -> Sudowoodo (树才怪)

Hoppip (毽子草) -> Skiploom (毽子花) -> Jumpluff (毽子棉)

Aipom (长尾怪手) -> Ambipom (双尾怪手)

Sunkern (向日种子) -> Sunflora (向日花怪)

Yanma (蜻蜻蜓) -> Yanmega (远古巨蜓)

Wooper (乌波) -> Quagsire (沼王)

Wooper-Paldea -> Clodsire (土王)

Murkrow (黑暗鸦) -> Honchkrow (乌鸦头头)

Misdreavus (梦妖) -> Mismagius (梦妖魔)

Girafarig (麒麟奇) -> Farigiraf (奇麒麟)

Pineco (榛果球) -> Forretress (佛烈托斯)

Dunsparce (土龙弟弟) -> Dudunsparce (土龙节节), Dudunsparce-Three-Segment

Gligar (天蝎) -> Gliscor (天蝎王)

Snubbull (布鲁) -> Granbull (布鲁皇)

Qwilfish (千针鱼)

Qwilfish-Hisui -> Overqwil (万针鱼)

Heracross (赫拉克罗斯)

Sneasel (狃拉) -> Weavile (玛狃拉)

Sneasel-Hisui -> Sneasler (大狃拉)

Teddiursa (熊宝宝) -> Ursaring (圈圈熊) -> Ursaluna (月月熊)

Slugma (熔岩虫) -> Magcargo (熔岩蜗牛)

Swinub (小山猪) -> Piloswine (长毛猪) -> Mamoswine (象牙猪)

Delibird (信使鸟)

Skarmory (盔甲鸟)

Houndour (戴鲁比) -> Houndoom (黑鲁加)

Phanpy (小小象) -> Donphan (顿甲)

Stantler (惊角鹿) -> Wyrdeer (诡角鹿)

Smeargle (图图犬)

Raikou (雷公)

Entei (炎帝)

Suicune (水君)

Larvitar (幼基拉斯) -> Pupitar (沙基拉斯) -> Tyranitar (班基拉斯)

Lugia (洛奇亚)

Ho-Oh (凤王)

Treecko (木守宫) -> Grovyle (森林蜥蜴) -> Sceptile (蜥蜴王)

Torchic (火稚鸡) -> Combusken (力壮鸡) -> Blaziken (火焰鸡)

Mudkip (水跃鱼) -> Marshtomp (沼跃鱼) -> Swampert (巨沼怪)

Poochyena (土狼犬) -> Mightyena (大狼犬)

Lotad (莲叶童子) -> Lombre (莲帽小童) -> Ludicolo (乐天河童)

Seedot (橡实果) -> Nuzleaf (长鼻叶) -> Shiftry (狡猾天狗)

Wingull (长翅鸥) -> Pelipper (大嘴鸥)

Ralts (拉鲁拉丝) -> Kirlia (奇鲁莉安) -> Gardevoir (沙奈朵), Gallade (艾路雷朵)

Surskit (溜溜糖球) -> Masquerain (雨翅蛾)

Shroomish (蘑蘑菇) -> Breloom (斗笠菇)

Slakoth (懒人獭) -> Vigoroth (过动猿) -> Slaking (请假王)

Makuhita (幕下力士) -> Hariyama (铁掌力士)

Nosepass (朝北鼻) -> Probopass (大朝北鼻)

Sableye (勾魂眼)

Meditite (玛沙那) -> Medicham (恰雷姆)

Plusle (正电拍拍)

Minun (负电拍拍)

Volbeat (电萤虫)

Illumise (甜甜萤)

Gulpin (溶食兽) -> Swalot (吞食兽)

Numel (呆火驼) -> Camerupt (喷火驼)

Torkoal (煤炭龟)

Spoink (跳跳猪) -> Grumpig (噗噗猪)

Trapinch (大颚蚁) -> Vibrava (超音波幼虫) -> Flygon (沙漠蜻蜓)

Cacnea (刺球仙人掌) -> Cacturne (梦歌仙人掌)

Swablu (青绵鸟) -> Altaria (七夕青鸟)

Zangoose (猫鼬斩)

Seviper (饭匙蛇)

Barboach (泥泥鳅) -> Whiscash (鲶鱼王)

Corphish (龙虾小兵) -> Crawdaunt (铁螯龙虾)

Feebas (丑丑鱼) -> Milotic (美纳斯)

Shuppet (怨影娃娃) -> Banette (诅咒娃娃)

Duskull (夜巡灵) -> Dusclops (彷徨夜灵) -> Dusknoir (黑夜魔灵)

Tropius (热带龙)

Chingling (铃铛响) -> Chimecho (风铃铃)

Snorunt (雪童子) -> Glalie (冰鬼护), Froslass (雪妖女)

Luvdisc (爱心鱼)

Bagon (宝贝龙) -> Shelgon (甲壳龙) -> Salamence (暴飞龙)

Beldum (铁哑铃) -> Metang (金属怪) -> Metagross (巨金怪)

Regirock (雷吉洛克)

Regice (雷吉艾斯)

Registeel (雷吉斯奇鲁)

Latias (拉帝亚斯)

Latios (拉帝欧斯)

Kyogre (盖欧卡)

Groudon (固拉多)

Rayquaza (烈空坐)

Jirachi (基拉祈)

Deoxys (代欧奇希斯)

Turtwig (草苗龟) -> Grotle (树林龟) -> Torterra (土台龟)

Chimchar (小火焰猴) -> Monferno (猛火猴) -> Infernape (烈焰猴)

Piplup (波加曼) -> Prinplup (波皇子) -> Empoleon (帝王拿波)

Starly (姆克儿) -> Staravia (姆克鸟) -> Staraptor (姆克鹰)

Kricketot (圆法师) -> Kricketune (音箱蟀)

Shinx (小猫怪) -> Luxio (勒克猫) -> Luxray (伦琴猫)

Cranidos (头盖龙) -> Rampardos (战槌龙)

Shieldon (盾甲龙) -> Bastiodon (护城龙)

Combee (三蜜蜂) -> Vespiquen (蜂女王)

Pachirisu (帕奇利兹)

Buizel (泳圈鼬) -> Floatzel (浮潜鼬)

Shellos (无壳海兔) -> Gastrodon (海兔兽)

Drifloon (飘飘球) -> Drifblim (随风球)

Stunky (臭鼬噗) -> Skuntank (坦克臭鼬)

Bronzor (铜镜怪) -> Bronzong (青铜钟)

Spiritomb (花岩怪)

Gible (圆陆鲨) -> Gabite (尖牙陆鲨) -> Garchomp (烈咬陆鲨)

Riolu (利欧路) -> Lucario (路卡利欧)

Hippopotas (沙河马) -> Hippowdon (河马兽)

Croagunk (不良蛙) -> Toxicroak (毒骷蛙)

Finneon (荧光鱼) -> Lumineon (霓虹鱼)

Snover (雪笠怪) -> Abomasnow (暴雪王)

Rotom (洛托姆)

Uxie (由克希)

Mesprit (艾姆利多)

Azelf (亚克诺姆)

Dialga (帝牙卢卡)

Palkia (帕路奇亚)

Heatran (席多蓝恩)

Regigigas (雷吉奇卡斯)

Giratina (骑拉帝纳)

Cresselia (克雷色利亚)

Phione (霏欧纳)

Manaphy (玛纳霏)

Darkrai (达克莱伊)

Shaymin (谢米)

Arceus (阿尔宙斯)

Snivy (藤藤蛇) -> Servine (青藤蛇) -> Serperior (君主蛇)

Tepig (暖暖猪) -> Pignite (炒炒猪) -> Emboar (炎武王)

Oshawott (水水獭) -> Dewott (双刃丸) -> Samurott (大剑鬼), Samurott-Hisui

Blitzle (斑斑马) -> Zebstrika (雷电斑马)

Drilbur (螺钉地鼠) -> Excadrill (龙头地鼠)

Timburr (搬运小匠) -> Gurdurr (铁骨土人) -> Conkeldurr (修建老匠)

Sewaddle (虫宝包) -> Swadloon (宝包茧) -> Leavanny (保姆虫)

Cottonee (木棉球) -> Whimsicott (风妖精)

Petilil (百合根娃娃) -> Lilligant (裙儿小姐), Lilligant-Hisui

Basculin (野蛮鲈鱼)

Basculin-White-Striped -> Basculegion (幽尾玄鱼), Basculegion-F

Sandile (黑眼鳄) -> Krokorok (混混鳄) -> Krookodile (流氓鳄)

Scraggy (滑滑小子) -> Scrafty (头巾混混)

Zorua (索罗亚) -> Zoroark (索罗亚克)

Zorua-Hisui -> Zoroark-Hisui

Minccino (泡沫栗鼠) -> Cinccino (奇诺栗鼠)

Gothita (哥德宝宝) -> Gothorita (哥德小童) -> Gothitelle (哥德小姐)

Solosis (单卵细胞球) -> Duosion (双卵细胞球) -> Reuniclus (人造细胞卵)

Ducklett (鸭宝宝) -> Swanna (舞天鹅)

Deerling (四季鹿) -> Sawsbuck (萌芽鹿)

Foongus (哎呀球菇) -> Amoonguss (败露球菇)

Alomomola (保姆曼波)

Joltik (电电虫) -> Galvantula (电蜘蛛)

Tynamo (麻麻小鱼) -> Eelektrik (麻麻鳗) -> Eelektross (麻麻鳗鱼王)

Litwick (烛光灵) -> Lampent (灯火幽灵) -> Chandelure (水晶灯火灵)

Axew (牙牙) -> Fraxure (斧牙龙) -> Haxorus (双斧战龙)

Cubchoo (喷嚏熊) -> Beartic (冻原熊)

Cryogonal (几何雪花)

Mienfoo (功夫鼬) -> Mienshao (师父鼬)

Golett (泥偶小人) -> Golurk (泥偶巨人)

Pawniard (驹刀小兵) -> Bisharp (劈斩司令) -> Kingambit (仆刀将军)

Rufflet (毛头小鹰) -> Braviary (勇士雄鹰), Braviary-Hisui

Vullaby (秃鹰丫头) -> Mandibuzz (秃鹰娜)

Deino (单首龙) -> Zweilous (双首暴龙) -> Hydreigon (三首恶龙)

Larvesta (燃烧虫) -> Volcarona (火神蛾)

Cobalion (勾帕路翁)

Terrakion (代拉基翁)

Virizion (毕力吉翁)

Tornadus (龙卷云)

Thundurus (雷电云)

Reshiram (莱希拉姆)

Zekrom (捷克罗姆)

Landorus (土地云)

Kyurem (酋雷姆)

Keldeo (凯路迪欧)

Meloetta (美洛耶塔)

Chespin (哈力栗) -> Quilladin (胖胖哈力) -> Chesnaught (布里卡隆)

Fennekin (火狐狸) -> Braixen (长尾火狐) -> Delphox (妖火红狐)

Froakie (呱呱泡蛙) -> Frogadier (呱头蛙) -> Greninja (甲贺忍蛙)

Fletchling (小箭雀) -> Fletchinder (火箭雀) -> Talonflame (烈箭鹰)

Scatterbug (粉蝶虫) -> Spewpa (粉蝶蛹) -> Vivillon (彩粉蝶), Vivillon-Fancy

Litleo (小狮狮) -> Pyroar (火炎狮)

Flabebe (花蓓蓓) -> Floette (花叶蒂) -> Florges (花洁夫人)

Skiddo (坐骑小羊) -> Gogoat (坐骑山羊)

Espurr (妙喵) -> Meowstic (超能妙喵), Meowstic-F

Inkay (好啦鱿) -> Malamar (乌贼王)

Skrelp (垃垃藻) -> Dragalge (毒藻龙)

Clauncher (铁臂枪虾) -> Clawitzer (钢炮臂虾)

Hawlucha (摔角鹰人)

Dedenne (咚咚鼠)

Carbink (小碎钻)

Goomy (黏黏宝) -> Sliggoo (黏美儿) -> Goodra (黏美龙)
Goomy (黏黏宝) -> Sliggoo-Hisui -> Goodra-Hisui

Klefki (钥圈儿)

Phantump (小木灵) -> Trevenant (朽木妖)

Bergmite (冰宝) -> Avalugg (冰岩怪), Avalugg-Hisui

Noibat (嗡蝠) -> Noivern (音波龙)

Diancie (蒂安希)

Hoopa (胡帕)

Volcanion (波尔凯尼恩)

Rowlet (木木枭) -> Dartrix (投羽枭) -> Decidueye (狙射树枭), Decidueye-Hisui

Litten (火斑喵) -> Torracat (炎热喵) -> Incineroar (炽焰咆哮虎)

Popplio (球球海狮) -> Brionne (花漾海狮) -> Primarina (西狮海壬)

Pikipek (小笃儿) -> Trumbeak (喇叭啄鸟) -> Toucannon (铳嘴大鸟)

Yungoos (猫鼬少) -> Gumshoos (猫鼬探长)

Grubbin (强颚鸡母虫) -> Charjabug (虫电宝) -> Vikavolt (锹农炮虫)

Crabrawler (好胜蟹) -> Crabominable (好胜毛蟹)

Oricorio (花舞鸟)

Cutiefly (萌虻) -> Ribombee (蝶结萌虻)

Rockruff (岩狗狗) -> Lycanroc (鬃岩狼人), Lycanroc-Midnight, Lycanroc-Dusk

Mareanie (好坏星) -> Toxapex (超坏星)

Mudbray (泥驴仔) -> Mudsdale (重泥挽马)

Dewpider (滴蛛) -> Araquanid (滴蛛霸)

Fomantis (伪螳草) -> Lurantis (兰螳花)

Salandit (夜盗火蜥) -> Salazzle (焰后蜥)

Bounsweet (甜竹竹) -> Steenee (甜舞妮) -> Tsareena (甜冷美后)

Comfey (花疗环环)

Oranguru (智挥猩)

Passimian (投掷猴)

Sandygast (沙丘娃) -> Palossand (噬沙堡爷)

Minior (小陨星)

Komala (树枕尾熊)

Mimikyu (谜拟丘)

Bruxish (磨牙彩皮鱼)

Jangmo-o (心鳞宝) -> Hakamo-o (鳞甲龙) -> Kommo-o (杖尾鳞甲龙)

Cosmog (科斯莫古) -> Cosmoem (科斯莫姆) -> Solgaleo (索尔迦雷欧), Lunala (露奈雅拉)

Necrozma (奈克洛兹玛)

Magearna (玛机雅娜)

Grookey (敲音猴) -> Thwackey (啪咚猴) -> Rillaboom (轰擂金刚猩)

Scorbunny (炎兔儿) -> Raboot (腾蹴小将) -> Cinderace (闪焰王牌)

Sobble (泪眼蜥) -> Drizzile (变涩蜥) -> Inteleon (千面避役)

Skwovet (贪心栗鼠) -> Greedent (藏饱栗鼠)

Rookidee (稚山雀) -> Corvisquire (蓝鸦) -> Corviknight (钢铠鸦)

Chewtle (咬咬龟) -> Drednaw (暴噬龟)

Rolycoly (小炭仔) -> Carkol (大炭车) -> Coalossal (巨炭山)

Applin (啃果虫) -> Dipplin (裹蜜虫) -> Hydrapple (蜜集大蛇)
Applin (啃果虫) -> Flapple (苹裹龙), Appletun (丰蜜龙)

Silicobra (沙包蛇) -> Sandaconda (沙螺蟒)

Cramorant (古月鸟)

Arrokuda (刺梭鱼) -> Barraskewda (戽斗尖梭)

Toxel (电音婴) -> Toxtricity (颤弦蝾螈), Toxtricity-Low-Key

Sinistea (来悲茶) -> Polteageist (怖思壶)

Sinistea-Antique -> Polteageist-Antique

Hatenna (迷布莉姆) -> Hattrem (提布莉姆) -> Hatterene (布莉姆温)

Impidimp (捣蛋小妖) -> Morgrem (诈唬魔) -> Grimmsnarl (长毛巨魔)

Milcery (小仙奶) -> Alcremie (霜奶仙)

Falinks (列阵兵)

Pincurchin (啪嚓海胆)

Snom (雪吞虫) -> Frosmoth (雪绒蛾)

Stonjourner (巨石丁)

Eiscue (冰砌鹅)

Indeedee (爱管侍)

Morpeko (莫鲁贝可)

Cufant (铜象) -> Copperajah (大王铜象)

Duraludon (铝钢龙) -> Archaludon (铝钢桥龙)

Dreepy (多龙梅西亚) -> Drakloak (多龙奇) -> Dragapult (多龙巴鲁托)

Zacian (苍响)

Zamazenta (藏玛然特)

Eternatus (无极汰那)

Kubfu (熊徒弟) -> Urshifu (武道熊师), Urshifu-Rapid-Strike

Zarude (萨戮德)

Regieleki (雷吉艾勒奇)

Regidrago (雷吉铎拉戈)

Glastrier (雪暴马)

Spectrier (灵幽马)

Calyrex (蕾冠王)

Enamorus (眷恋云)

Sprigatito (新叶喵) -> Floragato (蒂蕾喵) -> Meowscarada (魔幻假面喵)

Fuecoco (呆火鳄) -> Crocalor (炙烫鳄) -> Skeledirge (骨纹巨声鳄)

Quaxly (润水鸭) -> Quaxwell (涌跃鸭) -> Quaquaval (狂欢浪舞鸭)

Lechonk (爱吃豚) -> Oinkologne (飘香豚), Oinkologne-F

Tarountula (团珠蛛) -> Spidops (操陷蛛)

Nymble (豆蟋蟀) -> Lokix (烈腿蝗)

Pawmi (布拨) -> Pawmo (布土拨) -> Pawmot (巴布土拨)

Tandemaus (一对鼠) -> Maushold (一家鼠), Maushold-Four

Fidough (狗仔包) -> Dachsbun (麻花犬)

Smoliv (迷你芙) -> Dolliv (奥利纽) -> Arboliva (奥利瓦)

Squawkabilly (怒鹦哥)

Nacli (盐石宝) -> Naclstack (盐石垒) -> Garganacl (盐石巨灵)

Charcadet (炭小侍) -> Armarouge (红莲铠骑), Ceruledge (苍炎刃鬼)

Tadbulb (光蚪仔) -> Bellibolt (电肚蛙)

Wattrel (电海燕) -> Kilowattrel (大电海燕)

Maschiff (偶叫獒) -> Mabosstiff (獒教父)

Shroodle (滋汁鼹) -> Grafaiai (涂标客)

Bramblin (纳噬草) -> Brambleghast (怖纳噬草)

Toedscool (原野水母) -> Toedscruel (陆地水母)

Klawf (毛崖蟹)

Capsakid (热辣娃) -> Scovillain (狠辣椒)

Rellor (虫滚泥) -> Rabsca (虫甲圣)

Flittle (飘飘雏) -> Espathra (超能艳鸵)

Tinkatink (小锻匠) -> Tinkatuff (巧锻匠) -> Tinkaton (巨锻匠)

Wiglett (海地鼠) -> Wugtrio (三海地鼠)

Bombirdier (下石鸟)

Finizen (波普海豚) -> Palafin (海豚侠)

Varoom (噗隆隆) -> Revavroom (普隆隆姆)

Cyclizar (摩托蜥)

Orthworm (拖拖蚓)

Glimmet (晶光芽) -> Glimmora (晶光花)

Greavard (墓仔狗) -> Houndstone (墓扬犬)

Flamigo (缠红鹤)

Cetoddle (走鲸) -> Cetitan (浩大鲸)

Veluza (轻身鳕)

Dondozo (吃吼霸)

Tatsugiri (米立龙)

Great Tusk (雄伟牙)

Scream Tail (吼叫尾)

Brute Bonnet (猛恶菇)

Flutter Mane (振翼发)

Slither Wing (爬地翅)

Sandy Shocks (沙铁皮)

Iron Treads (铁辙迹)

Iron Bundle (铁包袱)

Iron Hands (铁臂膀)

Iron Jugulis (铁脖颈)

Iron Moth (铁毒蛾)

Iron Thorns (铁荆棘)

Frigibax (凉脊龙) -> Arctibax (冻脊龙) -> Baxcalibur (戟脊龙)

Gimmighoul (索财灵) -> Gholdengo (赛富豪)

Gimmighoul-Roaming -> Gholdengo (赛富豪)

Wo-Chien (古简蜗)

Chien-Pao (古剑豹)

Ting-Lu (古鼎鹿)

Chi-Yu (古玉鱼)

Roaring Moon (轰鸣月)

Iron Valiant (铁武者)

Koraidon (故勒顿)

Miraidon (密勒顿)

Walking Wake (波荡水)

Iron Leaves (铁斑叶)

Poltchageist (斯魔茶) -> Sinistcha (来悲粗茶)

Poltchageist-Artisan -> Sinistcha-Masterpiece

Okidogi (够赞狗)

Munkidori (愿增猿)

Fezandipiti (吉雉鸡)

Ogerpon (厄诡椪)

Gouging Fire (破空焰)

Raging Bolt (猛雷鼓)

Iron Boulder (铁磐岩)

Iron Crown (铁头壳)

Terapagos (太乐巴戈斯)

Pecharunt (桃歹郎)
